111111111111111
111111111111111
111991191199111
111113333311111
111111111111111
