_______________
_____11111_____
___991191199___
_____33333_____
_______________
