_______________
_____11111_____
___001101100___
_____33333_____
_______________
