_______________
__33111311133__
___111___111___
____11___11____
_______________
