_______________
_______________
___99__9__99___
_______________
1______________
