999999999999999
111111111111111
___111111111___
_____33333_____
_______________
