_______________
____1_____1____
___121___121___
____3_____3____
__9____4____9__
