999999999999999
_______________
___111121111___
_____33233_____
_______________
