_______________
_22___131___22_
____1151511____
__54__191___45_
___9________9__
