_______________
_____11111_____
___111111111___
_____33333_____
_______________
