_____33333_____
____3111113____
___311515113___
_____31113_____
______333______
