___187656781___
__1873___3781__
__13___4___31__
__1873___3781__
___187656781___
