_______________
_______________
___99__9__99___
__________1____
_______________
